NO ./asset/crystal_box.xpm
SO ./asset/crystal_imac.xpm
WE ./asset/crystal_sign.xpm
EA ./asset/crystal.xpm
F 220, 100, 0
C 225 , 30 , 0

            1111111111111111111111111                
            1000000000110000000000001    
            1011000001110000000000001           
            100100E0000000000000000011  
     111111111011000001110000000000001                        
     100000000011000001110111111111111
     11110111111111011100000010001                              
     11110111  1 1101 101010010001                                 
     11000000110101011100000010001
     10000000000000001100000010001                               
     10000000000000001101010010001           
     11000001110101011111011010001       
      1110111 11101011111111000001               
      1111111 1111111      1111111            


