NO ./asset/crystal_box.xpm
SO ./asset/crystal_imac.xpm
WE ./asset/crystal_sign.xpm
EA ./asset/crystal.xpm
F 220,100,122
C 225,225,225

11111
10001
10N01
10001
11111

