NO ./path_to_the_north_texture
SO ./path_to_the_south_texture
WE ./path_to_the_west_texture
EA ./path_to_the_east_texture
F 220,100,0
C 225,30,0

             11111111111111111111111                 
            1000000000110000000000001    
            1011000001110000000000001           
            1001000000000000000000001   
      11111111011000001110000000000001                        
     10000000001100000111011111111111
      1110111111111011100000010001                              
       110111  1 1101 101010010001                                 
      1000000110101011100000010001
     10000000000000001100000010001                               
     10000000000000001101010010001           
      100000111010101  11011010N01       
       11011   110101    1 1000001               
         1       1 1        11111             


