NO ./asset/crystal_imac.xpm
SO ./asset/crystal_box.xpm
WE ./asset/crystal.xpm
EA ./asset/crystal_sign.xpm
F 113,113,113
C 11,2,62

111111111111111
100000100S10001
100000101010001
110010000000101
100000100001001
100000000000101
100000000000001
100000000000001
100000000000001
100000000000001
100000000000011
100000000000001
110000000000001
100000000000001
100000000000001
100000000000001
100000001000001
100000000000001
100100000000001
100000000000001
100000000000001
100000000000001
100000000000101
100000100000001
100000000000001
100000001000001
100000000000001
100000000000001
100000000000001
100010000000001
100000000000001
100000000000001
100000000100001
100000000000001
100000000000001
100000000001001
100000000000001
100000000000001
100000000000001
100000000000001
111111111111111